#|#|#|##
---X----
###||###

##|#|#|#
----X---
###||###

##|#|#|#
----X---
###|||##